00000000000000000000000000000000000000000000000000
00000000000000000000000000000000000000000000000000
00000000000000000000000000000000000000000000000000
00000000000000000000000000000000000000000000000000
00000000000000000000000000000000000000000000000000
00000330000033000330000033000333333300033333333000
00000330000033000330000033000333333300033333333000
00000330000033000330000033000330000000000033000000
00000330000033000330000033000330000000000033000000
00000330000033000330000033000330000000000033000000
00000330000033000330000033000330000000000033000000
00000333333333000330000033000333333300000033000000
00000333333333000330000033000333333300000033000000
00000330000033000330000033000000003300000033000000
00000330000033000330000033000000003300000033000000
00000330000033000330000033000000003300000033000000
00000330000033000330000033000000003300000033000000
00000330000033000333333333000333333300000033000000
00000330000033000333333333000333333300000033000000
00000000000000000000000000000000000000000000000000
00000000000000000000000000000000000000000000000000
00000000000000000022220000022220000000000000000000
00000000000000000222222222222222000000000000000000
00000000000000000222000222000222000000000000000000
00000000000000000220000000000022000000000000033333
33333000000000000220000000000022000000000000033333
33333000000000000022000000000220000000000000000000
00000000000000000002000000000200000000000000000000
00000000000000000002200000002200000000000000000000
00000000000000000000222000222000000000000000000000
00000000000000000000002222200000000000000000000000
00000000000000000000000020000000000000000000000000
00000000000000000000000000000000000000000000000000
00000000000000000000000000000000000000000000000000
00000000000000000000000000000000000000000000000000
00000000000000000000033333330000000000000000000000
00000000000000000000033333330000000000000000000000
00000000000000000000033000330000000000000000000000
00000000000000000000033000330000000000000000000000
00000000000000000000033000330000000000000000000000