00000000000000000000000000000000000000000000000000
00000000000000000000000000000000000000000000000000
00000000000000000000000000000000000000000000000000
00000000000000000000000000000000000000000000000000
00000000000000000000000000000000000000000000000000
00000440000044000440000044000444444400044444444000
00000440000044000440000044000444444400044444444000
00000440000044000440000044000440000000000044000000
00000440000044000440000044000440000000000044000000
00000440000044000440000044000440000000000044000000
00000440000044000440000044000444444400000044000000
00000444444444000440000044000444444400000044000000
00000444444444000440000044000000004400000044000000
00000440000044000440000044000000004400000044000000
00000440000044000440000044000000004400000044000000
00000440000044000440000044000444444400000044000000
00000440000044000444444444000444444400000000000000
00000440000044000444444444000000000000000000000000
00000440000044000000000000000000000000000000000000
00000000000000000000000000000000000000000000000000
00000000000000000000000000000000000000000000000000
00000000000000000022220000022220000000000000000000
00000000000000000222222222222222000000000000000000
00000000000000000222000222000222000000000000000000
00000000000000000220000000000022000000000000033333
33333000000000000220000000000022000000000000033333
33333000000000000022000000000220000000000000000000
00000000000000000002000000000200000000000000000000
00000000000000000002200000002200000000000000000000
00000000000000000000222000222000000000000000000000
00000000000000000000002222200000000000000000000000
00000000000000000000000020000000000000000000000000
00000000000000000000000000000000000000000000000000
00000000000000000000000000000000000000000000000000
00000000000000000000000000000000000000000000000000
00000000000000000000044444440000000000000000000000
00000000000000000000044444440000000000000000000000
00000000000000000000044000440000000000000000000000
00000000000000000000044000440000000000000000000000
00000000000000000000044000440000000000000000000000