00000000000000000000000000000000000000000000000000
00000000000000000000000000000000000000000000000000
00000000000000000000000000000000000000000000000000
00000000000000000000000000000000000000000000000000
00000000000000000000003000000003000000300033000003
00000333333333330000033300000003300000300033000033
00000333333333330000030300000003300000300033000330
00000000033000000000330330000003330000300033003300
00000000033000000000300030000003033000300033033000
00000000033000000003300033000003003000300033330000
00000000033000000003000003000003003300300033300000
00000000033000000033333333300003000300300033330000
00000000033000000030000000300003000300300033030000
00000000033000000030000000300003000300300033033000
00000000033000000330000000330003000330300033003300
22222222233000000300000000030003000033322233000330
22222222233000003300000000033003000003322233000033
22222222233000003000000000003003000003322233000003
00000000000000000000000000000000000000000000000000
00000000000000000000000000000000000000000000000000
00000000000000000000000000000000000000000000000000
00000000000000000000000000000000000000000000000000
33333300003333333334444444444443333333000033333333
33333300003333333334333333333343333333000033333333
33333300003333333334333333333343333333000033333333
33000000000000000000000000000000000000000000000033
33000000000000000000000000000000000000000000000033
33000000000000000000000000000000000000000000000033
00000000000000000000000000000000000000000000000000
00000000000000000000000000000000000000000000000000
00000000000000000000000000000000000000000000000000
00000000000000000000000000000000000000000000000000
00000000000000000000000000000000000000000000000000
00000000000000000000000000000000000000000000000000
00000000000000000000000000000000000000000000000000
00000000000000000000033333330000000000000000000000
00000000000000000000033333330000000000000000000000
00000000000000000000033000330000000000000000000000
00000000000000000000033000330000000000000000000000
00000000000000000000033000330000000000000000000000

