00000000000000000000000000000000000000000000000000
00000000000000000000000000000000000000000000000000
00000000000000000000000000000000000000000000000000
00000000000000000000000000000000000000000000000000
00000000000000000000004000000004000000400044000004
00000444444444440000044400000004400000400044000044
00000444444444440000040400000004400000400044000440
00000000044000000000440440000004440000400044004400
00000000044000000000400040000004044000400044044000
00000000044000000004400044000004004000400044440000
00000000044000000004000004000004004400400044400000
00000000044000000044444444400004000400400044440000
00000000044000000040000000400004000400400044040000
00000000044000000040000000400004000400400044044000
00000000044000000440000000440004000440400044004400
22222222244000000400000000040004000044422244000440
22222222244000004400000000044004000004422244000044
22222222244000004000000000004004000004422244000004
00000000000000000000000000000000000000000000000000
00000000000000000000000000000000000000000000000000
00000000000000000000000000000000000000000000000000
00000000000000000000000000000000000000000000000000
44444400044444444444434444344444444444400044444444
44444400044444444444434444344444444444400044444444
44444400044444444444433333344444444444400044444444
33000000000000000000000000000000000000000000000033
33000000000000000000000000000000000000000000000033
33000000000000000000000000000000000000000000000033
00000000000000000000000000000000000000000000000000
00000000000000000000000000000000000000000000000000
00000000000000000000000000000000000000000000000000
00000000000000000000000000000000000000000000000000
00000000000000000000000000000000000000000000000000
00000000000000000000000000000000000000000000000000
00000000000000000000000000000000000000000000000000
00000000000000000000044444440000000000000000000000
00000000000000000000044444440000000000000000000000
00000000000000000000044000440000000000000000000000
00000000000000000000044000440000000000000000000000
00000000000000000000044000440000000000000000000000

