00000000000000000000000000000000000000000000000000
00000000000000000000000000000000000000000000000000
00000000000000000000000000000000000000000000000000
00003333333333300003333333333333333333333333330000
00003333333333300003333333333333333333333333330000
00000000330000000003333000000000000000000003330000
00000000330000000003333000000000000000000003330000
00000000330000000003333000000000000000000003330000
00000000330000000003333000000000000000000003330000
00000000330000000003333000000000000000000003330000
00000000330000000003333000000000000000000003330000
00000000330000000003333000000000000000000003330000
00000000330000000003333000000000000000000003330000
00003333333333300003333000000000000000000003330000
00003333333333300003333333333333333333333333330000
00003333333333300003333333333333333333333333330000
22222222222222222222222222222222222222222222222222
22222222222222222222222222222222222222222222222222
22222222222222222222222222222222222222222222222222
00000000000000000000000333330000000000000000000000
00000000000000000000000333330000000000000000000000
00000000000000000000000333330000000000000000000000
00000000000000000000000333330000000000000000000000
00000000000000000000000333330000000000000000000000
33334444444440000000000000000000000444444444443333
33334444444440000000000000000000000444444444443333
33334444444440000000000000000000000444444444443333
00000004440000000000000000000000000000000444000000
00000004440000000000000000000000000000000444000000
00000004440000000000000000000000000000000444000000
00000004440000000000000000000000000000000444000000
00000004440000000000000000000000000000000444000000
00000004440000000000000000000000000000000444000000
00000004440000000000000000000000000000000444000000
00000004440000000000000000000000000000000000000000
00000000000000000000033333330000000000000000000000
00000000000000000000033333330000000000000000000000
00000000000000000000033000330000000000000000000000
00000000000000000000033000330000000000000000000000
00000000000000000000033000330000000000000000000000