00000000000000000000000000000000000000000000000000
00000000000000000000000000000000000000000000000000
00000000000000000000000000000000000000000000000000
00004444444444400004444444444444444444444444440000
00004444444444400004444444444444444444444444440000
00000000330000000004444000000000000000000004440000
00000000330000000004444000000000000000000004440000
00000000330000000004444000000000000000000004440000
00000000330000000004444000000000000000000004440000
00000000330000000004444000000000000000000004440000
00000000330000000004444000000000000000000004440000
00000000330000000004444000000000000000000004440000
00000000330000000004444000000000000000000004440000
00004444444444400004444000000000000000000004440000
00004444444444400004444444443333333333444444440000
00004444444444400004444444443333333333444444440000
22222222222222222222222222222222222222222222222222
22222222222222222222222222222222222222222222222222
22222222222222222222222222222222222222222222222222
00000000000000000000000333330000000000000000000000
00000000000000000000000333330000000000000000000000
00000000000000000000000333330000000000000000000000
00000000000000000000000333330000000000000000000000
00000000000000000000000333330000000000000000000000
33334444444440000000000000000000000444444444443333
33334444444440000000000000000000000444444444443333
33334444444440000000000000000000000444444444443333
00000004440000000000000000000000000000000444000000
00000004440000000000000000000000000000000444000000
00000004440000000000000000000000000000000444000000
00000004440000000000000000000000000000000444000000
00000004440000000000000000000000000000000444000000
00000004440000000000000000000000000000000444000000
00000004440000000000000000000000000000000444000000
00000004440000000000000000000000000000000000000000
00000000000000000000044444440000000000000000000000
00000000000000000000044444440000000000000000000000
00000000000000000000044000440000000000000000000000
00000000000000000000044000440000000000000000000000
00000000000000000000044000440000000000000000000000