00000000000000000000000000000000000000000000000000
00000000000000000000000000000000000000000000000000
00000000000000000000000000000000000000000000000000
00000000000000000000000000000000000000000000000000
00000004444444400000000000000000000000444444400000
00000044000000440000000000000000000004400000440000
00000040000000040000000000000000000004000000040000
00000040000000440000000000000000000004400000040000
00000044444444400000000000000000000000444444440000
00000000000000000000000000000000000000000000000000
00000000000000000000000000000000000000000000000000
00000000000000000000000000000000000000000000000000
00000000000000000000000000000000000000000000000000
00000000000000000000000022200000000000000000000000
00000000000000000000000222222000000000000000000000
00000000000000000000022205502220000000000000000000
00000000000000000002200005500022200000000000000000
00000000000000000220000005500000222200000000000000
00000000000000222200000005500000000220000000000000
00000000000000000000000005500000000000000000000000
00000000000000000000000005500000000000000000000000
00000000000000000000200005500020000000000000000000
00000000000000000000220005500220000000000000000000
33333333000000000000022005502200000000000033333333
00000003000000000000002222222000000000000030000000
00000003000000000000000000000000000000000030000000
00000003000000000000000000000000000000000030000000
00000003444444444444444444444444444444444430000000
00000003444444444444444444444444444444444430000000
00000000000000000000000000000000000000000000000000
00000000000000000000000000000000000000000000000000
00000000000000000000000000000000000000000000000000
00000000000000000000000000000000000000000000000000
00000000000000000000000000000000000000000000000000
00000000000000000000000000000000000000000000000000
00000000000000000000033333330000000000000000000000
00000000000000000000033333330000000000000000000000
00000000000000000000033000330000000000000000000000
00000000000000000000033000330000000000000000000000
00000000000000000000033000330000000000000000000000